..............................................................................................
..................,,,...,,,..........................,,,?,,,.....................,,,...........
..,,,..........................................................................................
...............###########...........................#######..................#######......,,,,
...................................................##..........................................
..........,,,,,,.............................##.......................,,,,,..........#####.....
...............................###########.........................########....................
.......###########.................................,,,,,..,,,..................................
..........................,,,,...,,,,,,,1.........############.....................?...........
.s@..........................................................................................e.
###############################################################################################
///////////////////////////////////////////////////////////////////////////////////////////////
///////////////////////////////////////////////////////////////////////////////////////////////
///////////////////////////////////////////////////////////////////////////////////////////////                                                                                                                                                                                                                                                                                                                                                                                          