,,,...............,,,...,,,............................,,,,,.....................,,,...........
........................................................?......................................
...............###########...........................#######..................#######......,,,,
.................................,,,,,,,...........##..........................................
..........,,,,,,.............................##.......................,,,,,..........#####.....
...............................###########.........................########....................
.......###########.................................,,,,,..,,,..................................
..........................,,,,...........?.........###########.....................?...........
..@............................................................................................
###############################################################################################
///////////////////////////////////////////////////////////////////////////////////////////////
///////////////////////////////////////////////////////////////////////////////////////////////
///////////////////////////////////////////////////////////////////////////////////////////////                                                                                                                                                                                                                                                                                                                                                                                          