,,,...............,,,...,,,............................,,,,,.....................,,,...........
........................................................?......................................
...............###########...........................#######..................#######......,,,,
.................................,,,,,,,.......................................................
..........,,,,,,......................................................,,,,,....................
...............................###########.....................................................
.......###########.................................,,,,,..,,,..................................
..........................,,,,...........?.........###########.....................?...........
..@............................................................................................
###############################################################################################
///////////////////////////////////////////////////////////////////////////////////////////////
///////////////////////////////////////////////////////////////////////////////////////////////
///////////////////////////////////////////////////////////////////////////////////////////////                                                                                                                                                                                                                                                                                                                                                                                          