..................,,,...,,,............................,,,,,.....................,,,...........
..,,,.....................................................?....................................
...............###########...........................#######..................#######......,,,,
...................................................##..........................................
..........,,,,,,.............................##.......................,,,,,..........#####.....
...............................###########.........................########....................
.......###########......................1..........,,,,,..,,,..................................
..........................,,,,...,,,,,,,..........############.....................?...........
..@............................................................................................
###############################################################################################
///////////////////////////////////////////////////////////////////////////////////////////////
///////////////////////////////////////////////////////////////////////////////////////////////
///////////////////////////////////////////////////////////////////////////////////////////////                                                                                                                                                                                                                                                                                                                                                                                          