..................,,,...,,,............................,,,,,.....................,,,...........
..,,,.....................................................?....................................
...............###########...........................#######..................#######......,,,,
.................................,,,,,,,...........##..........................................
..........,,,,,,.............................##.......................,,,,,..........#####.....
...............................###########.........................########....................
.......###########.................................,,,,,..,,,..................................
..........................,,,,...........?........############.....................?...........
.!@............................................................................................
###############################################################################################
///////////////////////////////////////////////////////////////////////////////////////////////
///////////////////////////////////////////////////////////////////////////////////////////////
///////////////////////////////////////////////////////////////////////////////////////////////                                                                                                                                                                                                                                                                                                                                                                                          