..........................................h....................................................
..................,,,...,,,........h.................,,,?,,,.....................,,,......h....
..,,,..................................d.....................................................h.
...............###########...........................#######..........d.......#######......,,,,
..h................................................##................,,,,,.....................
....h.....,,,,,,.............................##......................................#####.....
...............................###########.........,,,,,..,,,......########....................
.......###########.............................................................................
..........................,,,,...,,,,,,,1.........############.....................?...........
.s@..........................................................................................e.
###############################################################################################
///////////////////////////////////////////////////////////////////////////////////////////////
///////////////////////////////////////////////////////////////////////////////////////////////
///////////////////////////////////////////////////////////////////////////////////////////////                                                                                                                                                                                                                                                                                                                                                                                          