/.............4.......1.........1.....,,,...,,...,,...,,,....4.....2.............1............/
/....................................,...,,,..,,,..,,,...,,.................................../
/.....################################....#....#....#....################################...../
/....../,.,.,.,.,.,.,.,../TTTTTTTTTTT..........k........./i..k........................./i...../
/....../.,.,.,.,.,.,.,.4./.............................../i...............4............/i...../
/##..../,.,.,.,.,.,.,.,../.............................../i............................/....##/
/i.#.../.,..........#####/.......................##....../i..##..#..###..##..##..#...../....../
/i...../,.,..2.........................................../i....................../...../....../
/i...../.,.............................................../ttttttttttttttttttttttt/...../....../
/.....#/,.,####..............................5..........#/#######################/....#/#...../
/....../.,...k/..............................................,.,.,.,.,.,.,.,.........../i...../
/..@.../,.,4../i...................1........................,.,.,.,.,.,.,.,.,...1....../i...e./
/....../.,..../i.............................................,.,.,.,.,.,.,.,.........../i...../
/######/######/########################################################################/######/
///////////////////////////////////////////////////////////////////////////////////////////////
///////////////////////////////////////////////////////////////////////////////////////////////                                                                                                                                                                                                                                                                                                                                                         