...............................................................................................
...............................................................................................
.............,,,2,,,.....................1.....................................................
...............................................................................1...............
............#########.............###########......,,,,.2......................................
,,,,,,.1...............................................................#########...............
.......................,,,,.2.....................###########...,,,,..#........................
#########.....................##.................#///////////##................................
..............2.,,,,,.########//#####........,,,...............#####...........................
...............................................................................................
.s..........##########..............1.....########.............1.....,,,,,,,,,....1..........e.
...@........//////////....................////////.............................................
############//////////####################////////#############################################
///////////////////////////////////////////////////////////////////////////////////////////////
///////////////////////////////////////////////////////////////////////////////////////////////
///////////////////////////////////////////////////////////////////////////////////////////////                                                                                                                                                                                                                                                                                                                                                                               