...............................................................................................
...............................................................................................
..f......,,,,,...,,,,,,1................,,,...,,,..............#..........................f....
...f................................###.,,,...,,,.###........../......................f........
........#################...............,,,...,,,....###.....2./....#,,........................
........................................,,,.#.,,,.......###..../..../,,........................
###.....................................,,,...,,,..........####/..../,,.2.,,,,2.,,,,2..........
.............2......2.........###.......,,,...,,,............../..../,,...................#....
....................................ttttt.......ttttt........../..../#####################/....
........#...####...####.............#######...#######.....f....................................
......../..................#................................f..................................
.s.@..../................../............1.....1.....1..............1......1.......1..........e.
......../tttttttttttttttttt/...................................................................
########/##################/###################################################################
///////////////////////////////////////////////////////////////////////////////////////////////
///////////////////////////////////////////////////////////////////////////////////////////////                                                                                                                                                                                                                                                                                                                                                                          