..............................2...1.........................................................../
.............................................2..1..............................,,,......,,,.../
....................2.....#########......................,,,.............,,,........#........./
......................................#############i.........................#....../........./
2...........2......####.........................../i..,,,,,,..1.......#....../....../........./
................................................../i...........#....../....../....../...,,,.../
##......########tttttttttttttttttttttttttttttttttt/############/tttttt/tttttt/tttttt/........./
/.#...../TTTTTTT##################################/TTTTTTTTTTTTT######/######/######/........./
/.....@./.......TTT...........TTT.......TTT........................................,,,,......./
/......./i..................................................................................../
/s....##/i.e............2.....1....2...1...1....1....1......1.......2......1....2...1.....1.../
/.,,,.///i..................................................................................../
/#####///#####################################################################################/
///////////////////////////////////////////////////////////////////////////////////////////////
///////////////////////////////////////////////////////////////////////////////////////////////
///////////////////////////////////////////////////////////////////////////////////////////////                                                                                                                                                                                                                                                                                                                                                                               