...............................................................................................
...............................................................................................
..........................................h....................................................
..................,,,...,,,........h.................,,,2,,,.....................,,,......h....
..,,,..................................d.....................................................h.
...............###########...........................#######..........d.......#######......,,,,
..h................................................##................,,,,,.....................
....h.....,,,,,,.............................##......................................#####.....
...............................###########.........,,,,,..,,,......########....................
.......###########.............................................................................
.s........................,,,,...,,,,,,,1.........############.....................2.........e.
..@............................................................................................
###############################################################################################
///////////////////////////////////////////////////////////////////////////////////////////////
///////////////////////////////////////////////////////////////////////////////////////////////
///////////////////////////////////////////////////////////////////////////////////////////////                                                                                                                                                                                                                                                                                                                                                                                          