#######...................................................................######...............
/TTT............,,,,,,..1........................................,,,,,..1..........,,,,.1......
/...............................,,,,...1.......................................................
/s............###########...........................2,,,,,,....##########tttttt##########......
/...@........................###########.................................######........./..,,..
/########..........................................########............................./..,,..
///..........................................1................2.........2......,,,,,...1/..,,..
///........,,,,,,...1...........................................#......................./..,,..
///..................................##########..............###/##....###...###########/..,,..
///.,,,..############................/i.........................//i...................../......
///...............1.......1.....1...#/i....,,,,,,...1...........//i........1....1...1.../..e...
///.................................//i.........................//i...................../......
///#################################//##########################//#############################
///////////////////////////////////////////////////////////////////////////////////////////////
///////////////////////////////////////////////////////////////////////////////////////////////
///////////////////////////////////////////////////////////////////////////////////////////////                                                                                                                                                                                                                                                                                                                                                                          