...................#.,.#..........#.......,,,,,,,,1............................2.........1..,.,
,.,................/,.,/....##..../..........................................................,.
.,................./.,./........../......##########..........,,.............################,.,
,.,....2.........##/,.,/........../........................,,..,,....2.......................,.
.,................./.,./........../.....................,,,......,,,.........,,,,,,,,,,,.1..,.,
,.,..#####........./,.,/........../##................#####........######.....................,.
.,..............2../.,./........../.................#..../......../..../####################,.,
,.,................/,.,/tttttttttt/...........######/..../tttttttt/..........................,.
.............######/.,./##########/.........../........../########/.........,.,.,.,.,.......,.,
...........##...........TTTTTTTTTT.......#####/..............................,.,.,.,.,.......,.
...........//............................//..................2..............,.,.,.,.,.......,.,
.s@........//..................1.........//.e.........2...................2..,.,.,.,.,1......,.
...........//............................//................######..........................####
###########//############################//################//////##########################////
/////////////////////////////////////////////////////////////////////////////////////////////// 
///////////////////////////////////////////////////////////////////////////////////////////////
                                                                                                                                                                                                                                                                                                                                                                      